0 8 8 8 8 8 8 8 8 8 8 8 8 8 8 8 8 8 0
3 17 16 16 16 16 16 16 16 16 16 16 16 16 16 16 16 18 2
3 16 10 14 14 1 14 12 16 9 16 10 14 1 14 14 12 16 2
3 16 16 16 16 15 16 16 16 15 16 16 16 15 16 16 16 16 2
0 12 16 9 16 11 16 10 14 8 14 12 16 11 16 9 16 10 0
3 16 16 15 16 16 16 16 16 16 16 16 16 16 16 15 16 16 2
3 16 10 6 16 10 14 12 16 9 16 10 14 12 16 4 12 16 2
3 16 16 16 16 16 16 16 16 15 16 16 16 16 16 16 16 16 2
0 1 1 7 16 9 16 10 14 8 14 12 16 9 16 5 1 1 0
0 0 0 3 16 15 16 16 16 16 16 16 16 15 16 2 0 0 0
0 8 8 6 16 11 16 5 12 0 10 7 16 11 16 4 8 8 0
3 16 16 18 16 16 16 15 0 0 0 15 16 16 16 17 16 16 2
0 1 1 7 16 9 16 4 14 14 14 6 16 9 16 5 1 1 0
0 0 0 3 16 15 16 16 16 16 16 16 16 15 16 2 0 0 0
0 8 8 6 16 11 16 10 14 1 14 12 16 11 16 4 8 8 0
3 16 16 16 16 16 16 16 16 15 16 16 16 16 16 16 16 16 2
3 16 10 7 16 10 14 12 16 11 16 10 14 12 16 5 12 16 2 
3 16 16 15 16 16 16 16 16 16 16 16 16 16 16 15 16 16 2
0 12 16 11 16 9 16 10 14 1 14 12 16 9 16 11 16 10 0
3 16 16 16 16 15 16 16 16 15 16 16 16 15 16 16 16 16 2
3 16 10 14 14 8 14 12 16 11 16 10 14 8 14 14 12 16 2
3 18 16 16 16 16 16 16 16 16 16 16 16 16 16 16 16 17 2
0 1 1 1 1 1 1 1 1 1 1 1 1 1 1 1 1 1 0
